             XXXXXXXXXXXXXXXXXXXXXXXXXX       
             W       X                X         
             W       X           P    X         
             W       X                X         
             W       X                X           
             W       X                X            
             W       X                X         
             W       X                X       
             XUUUUUUUX                X       
             X       X                X       
             X       X                X         
             X                        X         
             X                        X         
             X                        X         
             X                        X         
             X                       6X         
             XXXXXXXXXXXXXXXXXXXXXXXXXX       
		
		
		
		
		
		