        XXXXXXXXXXXXXXXXXXXXXXXXXXXXXXXXXXXXXXXXXXXXXXXXXXXX
        X    P    X                                WWWWWWXXX
        X         X                                WWWWWWXXX
        X         X                                WWWWWWXXX
        X         X                                WWWWWWXXX
        X         X                                WWWWWWXXX
        X         X                                WWWWWWXXX
        X         X                                WWWWWWXXX
        X         X                                WWWWWWXXX
        X         X                                WWWWWWXXX
        X         X                                WWWWWWXXX
        X         X                                WWWWWWXXX
        X         X                                WWWWWWXXX
        X                                          WWWWWWXXX
        X                                          WWWWWWXXX
        X                                          WWWWWWXXX
        X                                          WWWWWWXXX
        X                                          WWWWWWXXX
        XXXXXXXXXXXXXXXXXXXXXXXXXXXXXXXXXXXXXXXXXXXXXXXXXXXX
		
		
		
		
		
		
		
		
		
		