             XXXXXXXXXXXXXXXXXXXXXXXXXX
             W                        X  
             W                        X  
             W                        X  
             W                        X    
             W                        X     
             W                        X  
             W        +               X
             XUUUUUUUUUU              X
             X                        X
             X                        X            
             X                        X  
             X                        X  
             X                       2X  
             X                  P    3X  
             X   +                   2X  
             XXXXXXXXXXXXXXXXXXXXXXXXXX
		
		
		
		
		
		