       XXXXXXXXXXXXXXXXXXXXXXXXXXXXXXXXXXXXXXXXXXXXXXXXXXXXXXXXXXXXXXXXXXXXXXXXXXXXXXXXXXXXXXXXXXXXXXXXXXXXXXXXXXXXXXXXXXXXXXXXXXXXX
       X                                                                                                                           X
       X                                                                                                                           X
       X                                                 XXXXXXXXXXXXXXXXX                                                         X
       XP                                                XXXXXXXXXXXXXXXXX                  XX         XXXXXXXXXXXXXXXXXXXXXX      X
       X                                                                                    XX         XXXXXXXXXXXXXXXXXXXXXX      X
       XXXXXX                                                                               XX         XX          XX              X
       XXXXXX                                                                               XX         XX          XX              X
       XXXXXX                                                                    XXXXXXXXXXXXX         XX          XX              X
       XXXXXXXXXXXX                          XXXXX                                          XX         XX                  XX      X
       XXXXXXXXXXXX                          XXXXX                                          XX         XX                  XX      X
       XXXXXXXXXXXX                          XXXXX                                          XX         XX                  XX      X
       XXXXXXXXXXXXXXXXXXXXXXXXXXXXXXXXXXXXXXXXXXXXXXXXXXXXXXXXXXXXXXXXXXXXXXXXXXXXXXXXXXXXXXXWWWWWWWWWXXXXXXXXXXXXXXXXXXXXXXXXXXXXX






