             XXXXXXXXXXXXXXXXXXXXXXXXXX
             W           R            X  
             W           R            X  
             W           R            X  
             W           R            X    
             W           R     P      X     
             W           R            X  
             W           R            X
             XUUUUUUUUUUUXDDDDDXDDDDDDX
             X           L            X
             X           L            X  
             X           L            X  
             X           L            X  
             X           L            X  
             X           L            X  
             X           L            X  
             XXXXXXXXXXXXXXXXXXXXXXXXXX
		
		
		
		
		
		