             XXXXXXXXXXXXXXXXXXXXXXXXXX
             X*                       X  
             X                        X  
             X                        X  
             X                        X    
             X                        X     
             X              P         X  
             X          *             X
             XUUUUUUUUUUU             X
             W                        X
             W                        X            
             W                        X  
             W                        X  
             W                        X  
             W                        X  
             W                       *X  
             XXXXXXXXXXXXXXXXXXXXXXXXXX
		
		
		
		
		
		