       XXXXXXXXXXXXXXXXXXXXXXXXXXXXXXXXXXXXXXXXXXXXXXXXXXXXXXXXXXXXXXXXXXXXXXXXXXXXXXXXXXXXXXXXXXXXXXXXXXXXXXXXXXXXXXXXXXXXXXXXXXXXX
       X                        X                                X          X                                                      X
       X                        X                                X                                                                 X
       X                        X                *               X                                                                 X
       X      X                 X           XXXXXXXXXX           X                     XXXXXXXX                                    X
       X                  *     X                                X                     X                                           X
       X                  X     X                                X       XXXX          X                                           X
       X                        X                                X          XXXX       X        XXXXXX       XXXXXXXXXXXXXX        X
       X                                                         X          X          X                                  X        X
       XP         XXX                                   XXXX     X          X          X                                  X        X
       X                                                         X          X          X                                  X        X
       XX                       X                                X          X      XXXXX                                  X        X
       XX                       X           XXXXX                X          X          X                               XXXX        X
       XX                       X                             XXXX          X          X                                  X        X
       XX                       X                                X          X          X             XXXXXXXX             X        X
       XXXXXXXXX                X                                X          XXXX       X                                  X        X
       XX               XXXXXXXXXXXXXX                           X          X          X                                  X        X
       XX               XXXXXXXXXXXXXX                           X          X          X                                  X        X
       XX               XXXXXXXXXXXXXX                           X          X          X                             *    X        X
       XXXXXXXXXXXXXXXXXXXXXXXXXXXXXXXXXXXXXX           XXXXXXXXXX          X      XXXXX                            XXXXXXX        X
       X                                    X                                          X                            XXXXXXX        X
       X                                    X                                          X                            XXXXXXX        X
       X                                    X                                          X        XXXXXXXXXXXXXXXXXXXXXXXXXXX        X
       X                X                   X                      XXXX     XXXX       X        L                         X        X
       X                X             XXXXXXXXXXXXX                         X          X        L                         X        X
       X                X                                                   X          X        L                         X        X
       X                X                                                   X      XXXXX        L                         X        X
       X                XXXXXXX                              X              X                   L                         X        X
       X                XXXXXXX                              X              X                   L                         X        X 
       X                XXXXXXX                              X              X                   L        *                X        X
       X                XXXXXXXXXXXXXXXXXXXXXXXXXXXXXXXXXXXXXXXXXXXXXXXXXXXXXXXXXXXXXXXXXXXXXXXXXXXXXXXXXXXXXXXXXXXXX     X        X
       X                                                                                                                  X        X
       X                                                                                                                  X        X
       X                                                                                                                XXX        X
       X                                                                                                              XXXXX        X
       X                        X                                X              X        XXXXXXX                    XXXXXXX        X
       X                        X                                X         XXXXXX        XXXXXXX                  XXXXXXXXX        X
       X             XXXXXXXX   X                                X              X        XXXXXXX                XXXXXXXXXXX        X
       X                        X                      X         X              X        XXXXXXX              XXXXXXXXXXXXX        X
       X                        X                      X         X*             X        XXXXXX             XXXXXXXXXXXXXXX        X
       XXXXXXX                  X                      X         XXXXXXXXXX     X                         XXXXXXXXXXXXXXXXX        X
       X                        X                      X                        X                       XXXXXXXXXXXXXXXXXXX        X
       X                        X                      X                        X                     XXXXXXXXXXXXXXXXXXXXX        X
       X*                       X                      X                        X                   XXXXXXXXXXXXXXXXXXXXXXXWWWWWWWWX
       XXXXXXXXXXXXXXXXXXXXXXXXXXXXXXXXXXXXXXXXXXXXXXXXXXXXXXXXXXXXXXXXXXXXXXXXXXXXXXXXXXXXXXXXXXXXXXXXXXXXXXXXXXXXXXXXXXXXXXXXXXXXX






