                 XXXXXXXXXXXXXXXXXXXXXXXXXXXXXXXXXXXXXXXXX
                 X                                       X
                 X             P                         X
                 X                                       X
                 X                                       X
                 X                                       X
                 X                                       X
                 X                                       X
                 X                                       X
                 XDDDDDDDDDDDDDDDDDDDDDDDDDDDDDDDDDDDDDDDX
                 X                                       X
                 X                                       X
                 X                                       X
                 X                                       X
                 X                                       X
                 X                                       X
                 X                                       X
                 X                                       X
                 X                                       X
                 X                                       X
                 X                                       X
                 X                                       X
                 X                                       X
                 X                                       X
                 X                                       X
                 X                                       X
                 X                                       X
                 X                                       X
                 X                                       X
                 X                                       X
                 X                                       X
                 XWWWWWWWWWWWWWWWWWWWWWWWWWWWWWWWWWWWWWWWX
		   
		   
		   
		   
		   
		   
		   
		   
		   
		   
		   
		   
		   