             XXXXXXXXXXXXXXXXXXXXXXXXXXXXXXXXXXXXXXXXXXXXXXXXXXXXXXXXXXXXXXXXXXXXXXXXXXXXXXXXXXXXXXXXXXXXXXXXXXXXXXXXXXXXXXXXXXXXXXXXXXXXXXXXXXXXXXXXXXXXXXXXXXXXXXXXXXXXXXXXXXXXXXXXXX       
             W       X                                                         X                              X                                                  R                    X         
             W       X                                                         X                              X                                                  R               P    X         
             W       X                                                        4X                              X                                                  R                    X         
             W       X                                                   XXXXXXX                              X                                                  R                    X           
             W       X        X                                                X                              X                                                  R                    X            
             W       X        X                                                X                              X                                                  R                    X         
             W       X        X   XXXXXXX                                     6X                              X3                                                 R                    X       
             XUUUUUUUX        X                             XXXXXXXXXXX       XX                              XX                                   4UUUUUUUUUUUUUX                    X       
             X       X        X                                                                               X                                    X             L                    X       
             X       X        X                                                                               X                                    X             L                    X         
             X       X        X                                                                               X                                    X             L                    X         
             X       X        X                XXXXXXXX                    XX               XXXXXXX           X           XXXXXX                   X             L                    X         
             X       X        X                                                                               X           XXXXXX                   X             L                    X         
             X       X        X                                                                               X           XXXXXX                   X             L                    X         
             X       X        X                                                                               X      6    XXXXXX                   X             L                    X         
             XUUUUUUUXDDDDDDDDX       XXXXXX                          XXXXXXXXXXXXXXXXX                       XDDDDDDXXXXXXXXXXXXXXXXXXXXXXXXXXXXXXXXXXXXXXXXXXXXXXXXXXXXXXXXXXXXXXXXXX        
             X       X        X                                                X                              X      X                                         X                      X         
             X       X        X                                                X                             +X      X                                         X                      X         
             X       X        X                                                X                              X      X                                         X                      X         
             X       X        X                                 XXXXXX         X      XXXXXXXXXXX             X      X                                         X                      X         
             XUUUUUUUX        XXXXXXXX                          XXXXX          X                              X      X6            XUUUUUUXXXXXXXXXXXXXX       X                      X         
             X       X        X                                                X                              X      XXXXXX        X      L            X       X         XXXXX        X         
             X       X        X                                                X                    XXXXXXXXXXX                    X      L            X                 X            X         
             X       X        X                                         XDDDDDDX                              X                    X      L            X                 X           5X         
             X       X        X           XXXXXXXXXX                    X      X                              X                    X      L            X                 X        XXXXX         
             X       X        X           XXXXXXXXXX                    X  *   X                              X                    X      L            X                 X            X         
             XUUUUUUUXDDDDDDDDXXXXXXXXXXXXXXXXXXXXXXXXXXXUUUUUUUXXXXXXXXXDDDDDDXXXXXXXXXXXXXXXXXXXXXXXXXXXXXXXXXXXXXXXXXXXXXXXXXXXXXDDDDXXXXXXUUUUUUXXXXXXXXXXXXXXXXXXXXXX            X         
             X       X                                  R                            XXXXXXX                                       X      X                           X  D            X         
             X       X                                  R                            XXXXXXX                                       X      X                           X  D            X         
             X       X                                  R                            XXXXXXX*                                      X      X                           X  DLLXXXXXXXUUUX         
             X       X                                  R                            XXXXXXX3                                      X      X                           X      X        X         
             XUUUUUUUXXXXXXXXXXXXXXXXXXXXXXXXX          XXXXXXXX                     XXXXXXXX                                             XDDDDDDXXXXXXXXUUUUUUXX     X      X        X         
             X                                          R   R        XXXXXXXXX                       XXXXXXXXX                            R                     X     X      X       +X         
             X                                          R   R        XXXXXXXXX                       XXXXXXXXX                            R                     X                   XXX         
             X                                          R   R        XXXXXXXXX                  X     XXXXXXXX                            R                     X                     X         
             X                                          R * R        XXXXXXXXX                  X    2XXXXXXXX                            R         626        *X                    8X               
             XXXXXXXXXXX  XXXXXXXXXXXXXXXXXXXXXXXXXXXXXXXUUUXXXXXXXXXXXXXXXXXXXXXXXXXXXXXXXXXXXXXXXXXXXXXXXXXXXXXXXXXXXXXXXXXXXXXXXXXXXXXXXXXXXXXXXXXXXXXXXXXXXXXXXXXXXXXXXXXXXXXXXXXXX                
                       X  R                                 X                  
                       X  R                                 X                  
                       X  R                                 X 
                       XXXXXXXX                             X					   
                              XXXXXXXXXXXXXXXXXXXX          X
                                                 X2         X
                                                 XXXXXXXXXXXX
		
		
		
		