             XXXXXXXXXXXXXXXXXXXXXXXXXXXXXXXXXXXXXXXXXXXXXXXXXXXXXXXXXXXXXXXXXXX                              XXXXXXXXXXXXXXXXXXXXXXXXXXXXXXXXXXXXXXXXXXXXXXXXXXXXXXXXXXXXXXXXXXXXXXXXX       
             W       X                                                         X                              X                                                  R                    X         
             W       X                                                         X                              X                                                  R               P    X         
             W       X                                                        4X                              X                                                  R                    X         
             W       X        X                                          XXXXXXX                              X                                                  R                    X           
             W       X        X                                                X                              X                                                  R                    X            
             W       X        X                                                X                              X                                                  R                    X         
             W       X        X   XXXXXXX                                     6X                              X6                                                 R                    X       
             XUUUUUUUX        X                             XXXXXXXXX         XX                              XX                                   XUUUUUUUUUUUUUX                    X       
             X       X        X                                                X                              X                                    X             L                    X       
             X       X        X                                                X                              X                                    X             L                    X         
             X       X        X                                                X                              X                                    X             L                    X         
             X       X        X                XXXXXXXX                        X                              X           XXXXXX                   X             L                    X         
             X       X        X                                                X                              X           XXXXXX                   X             L                    X         
             X       X        X                                                X                              X           XXXXXX                   X             L                    X         
             X       X        X                                                X                              X      6    XXXXXX                   X             L                    X         
             XUUUUUUUXDDDDDDDDX       XXXXXX                            XXXXXXXX                              XDDDDDDXXXXXXXXXXXXXXXXXXXXXXXXXXXXXXXXXXXXXXXXXXXXXXXXXXXXXXXXXXXXXXXXXX        
             X       X        X                                                X                              X      X                                         X                      X         
             X       X        X                                                X                              X      X                                         X                      X         
             X       X        X                                                X                              X      X                                         X                      X         
             X       X        X                                 XXXXXX         X                              X      X                                         X                      X         
             XUUUUUUUX        XXXXXXXX                          XXXXX          X                              X      X6            XUUUUUUXXXXXXXXXXXXXX       X                      X         
             X       X        X                                                X                              X      XXXXXX        X      L            X       X         XXXXX        X         
             X       X        X                                                X                              X                    X      L            X                 X            X         
             X       X        X                                        XXXXXXXXX                              X                    X      L            X                 X           5X         
             X       X        X           XXXXXXXXXX                           X                              X                    X      L            X                 X        XXXXX         
             X       X        X           XXXXXXXXXX                           X                              X                    X      L            X                 X            X         
             XUUUUUUUXDDDDDDDDXXXXXXXXXXXXXXXXXXXXXXXXXXXUUUUUUUXXXXXXXXXXXXXXXXXXXXXXXXXXXXXXXXXXXXXXXXXXXXXXXXXXXXXXXXXXXXXXXXXXXXXDDDDDXXXXUUUUUUXXXXXXXXXXXXXXXXXXXXXX            X         
             X       X                                  R                            XXXXXXXX                                      X      X                           X  D            X         
             X       X                                  R                            XXXXXXXX                                      X      X                           X  D            X         
             X       X                                  R                            XXXXXXXX                                      X      X                           X  DLLXXXXXXXUUUX         
             X       X                                  R                            XXXXXXXX                                      X      X                           X      X        X         
             XUUUUUUUX                                  XXXXXXXX                     XXXXXXXX                                             XDDDDDDXXXXXXXXUUUUUUXX     X      X        X         
             X                                          R            XXXXXXXXX                       XXXXXXXXX                            R                     X     X      X        X         
             X                                          R            XXXXXXXXX                       XXXXXXXXX                            R                     X                   XXX         
             X                                          R            XXXXXXXXX                       XXXXXXXXX                            R                     X                     X         
             X                                          R            XXXXXXXXX                       XXXXXXXXX                            R         626         X                    8X         
             XXXXXXXXXXXXXXXXXXXXXXXXXXXXXXXXXXXXXXXXXXXXXXXXXXXXXXXXXXXXXXXXXXXXXXXXXXXXXXXXXXXXXXXXXXXXXXXXXXXXXXXXXXXXXXXXXXXXXXXXXXXXXXXXXXXXXXXXXXXXXXXXXXXXXXXXXXXXXXXXXXXXXXXXXX                
		
		
		
		
		
		